##--############-##
#.....#..g........#
#.....#.....g..k..#
#....@|.....g.....#
###################