######
#.@..#
#@...#
#@...#
######